*****************************
G                           *
*************************** *
*                           *
*                           *
*                           *
*                           *
*                           *
*                  S        *
*                           *
*                           *
*                           *
*                           *
*                           *
****** **********************